    NO ./pics/greystone.xpm

    SO ./pics/mossy.xpm
    
    WE ./pics/redbrick.xpm
    
    EA ./pics/bluestone.xpm       
        S  ./pics/eagle_cl.xpm



   F 2,50,110

     C 20,142,87

        R 1024 768
 
         1 11111111111111111111111111
        11111100000000000000000000011
         1 112020000W0020020000000011
        11111002000200000202000000011
1111111110110000000000000000000011111   
100000000011000001110111100011111
10110111111111011100000010001
10110111111111011101110010001
10000000110111011100000010001
1222222220001001100000010001
1100120001011101110100010001111111
11011101110101011111011110000000001
11101011111101011111111010111110111  
111111 1111111111111111111111111111
1111111111111111111111111111111
10000000000000000000000001101
11111111101111111111111111101
        101111111111111111101
11111111100000000000000000001
11000000001100111111111111111
1111111110110011
1111111110000011
11111111001111111
1111111111111111  